Survivor
An Interactive Fiction by Ana
Release 1 / Serial number 220703 / Inform 7 build 6M62 (I6/v6.33 lib 6/12N) SD

Prasuma
Prašuma je kišna šuma puna čudnovatih zvijeri koje mogu zbuniti posjetitelje. Počela je lagano padati kiša, a u pozadini se čuju razni čudni zvukovi. U cijeloj prašumi posebno se ističe veliko, ljubičasto drvo koje ima crne plodove. Kroz prašumu prolazi snažna rijeka. Na istoku se nalazi portal koji vodi u drugu razinu.

Vidiš torbu pokraj ljubičastog drveta.

Crni plodovi, neobičnog izgleda i mirisa.

Osjetivši čovjekovu prisutnost žena mačka je došla i cijelo vrijeme je njen pogledam usmjeren ka tebi.

You can also see Prvi portal here.

>look at kovceg
Zlatne je boje, prekriven mnoštvom dragulja!

* * *

>look at torba
Zlatne je boje i možeš je otvoriti!

>open troba
You can't see any such thing.

>open torba
You open the torba, revealing a lampa.

>take lampa
Taken.

>inventory
You are carrying:
  a lampa

>look at lampa
Lampa je crne boje, služi osvjetljavanju prostora kad se spusti mrak.

* * *

>look at torba
Zlatne je boje i možeš je otvoriti!

>open a gtorba
You can't see any such thing.

>open a torba
You open the torba, revealing a boca.

* * *

>look at torba
Zlatne je boje i možeš je otvoriti!

>open torba
You open the torba, revealing a boca.

>take a boca
Taken.

>inventroy
That's not a verb I recognise.

>inventory
You are carrying:
  a boca

>drink boca
There's nothing suitable to drink here.

* * *

>open torba
You open the torba, revealing a boca.

>take boca
Taken.

>inventory
You are carrying:
  a boca

>drink boca
Ugh. You're probably going to r.

* * *

>look at torba
Zlatne je boje i možeš je otvoriti!

>look at drvo
Veliko i raskošno drvo čudnih plodova.

>look at ljubičasto
You can't see any such thing.

>look at veliko
Veliko i raskošno drvo čudnih plodova.

>look at plodovi
Crni plodovi se čine otrovni.

>take plodovi
That's hardly portable.

>eat plodovi
Oprez plodovi nisu jestivi jer su otrovni!!!

That's plainly inedible.

>eat plodovi
Oprez plodovi nisu jestivi jer su otrovni!!!

That's plainly inedible.

>eat torba
That's plainly inedible.

* * *

>w
(first opening Treci portal)
It seems to be locked.

>e
Prasuma
Prašuma je kišna šuma puna čudnovatih zvijeri koje mogu zbuniti posjetitelje. Počela je lagano padati kiša, a u pozadini se čuju razni čudni zvukovi. U cijeloj prašumi posebno se ističe veliko, ljubičasto drvo koje ima crne plodove. Na istoku se nalazi portal koji vodi u drugu razinu.

Vidiš torbu pokraj ljubičastog drveta.

You can also see Portal here.

>w
Pustinja
You can see Portal here.

>e
Prasuma
Prašuma je kišna šuma puna čudnovatih zvijeri koje mogu zbuniti posjetitelje. Počela je lagano padati kiša, a u pozadini se čuju razni čudni zvukovi. U cijeloj prašumi posebno se ističe veliko, ljubičasto drvo koje ima crne plodove. Na istoku se nalazi portal koji vodi u drugu razinu.

Vidiš torbu pokraj ljubičastog drveta.

You can also see Portal here.

>go portal
(first opening Portal)
It seems to be locked.

* * *

>w
(first opening Treci portal)
It seems to be locked.

>n
You can't go that way.

>e
Prasuma
Prašuma je kišna šuma puna čudnovatih zvijeri koje mogu zbuniti posjetitelje. Počela je lagano padati kiša, a u pozadini se čuju razni čudni zvukovi. U cijeloj prašumi posebno se ističe veliko, ljubičasto drvo koje ima crne plodove. Na istoku se nalazi portal koji vodi u drugu razinu.

Vidiš torbu pokraj ljubičastog drveta.

You can also see Portal here.

>go west
Pustinja
You can see Portal here.

>e
Prasuma
Prašuma je kišna šuma puna čudnovatih zvijeri koje mogu zbuniti posjetitelje. Počela je lagano padati kiša, a u pozadini se čuju razni čudni zvukovi. U cijeloj prašumi posebno se ističe veliko, ljubičasto drvo koje ima crne plodove. Na istoku se nalazi portal koji vodi u drugu razinu.

Vidiš torbu pokraj ljubičastog drveta.

You can also see Portal here.

>open portal
It seems to be locked.

* * *

>n
You can't go that way.

>s
You can't go that way.

>n
You can't go that way.

* * *

>e
Prasuma
Prašuma je kišna šuma puna čudnovatih zvijeri koje mogu zbuniti posjetitelje. Počela je lagano padati kiša, a u pozadini se čuju razni čudni zvukovi. U cijeloj prašumi posebno se ističe veliko, ljubičasto drvo koje ima crne plodove. Na istoku se nalazi portal koji vodi u drugu razinu.

Vidiš torbu pokraj ljubičastog drveta.

You can also see Portal here.

>go pustinja
You can't see any such thing.

>n
You can't go that way.

* * *

>s
You can't go that way.

>w
Pustinja
You can see Portal here.

>w
(first opening Portal)
It seems to be locked.

>e
Prasuma
Prašuma je kišna šuma puna čudnovatih zvijeri koje mogu zbuniti posjetitelje. Počela je lagano padati kiša, a u pozadini se čuju razni čudni zvukovi. U cijeloj prašumi posebno se ističe veliko, ljubičasto drvo koje ima crne plodove. Na istoku se nalazi portal koji vodi u drugu razinu.

Vidiš torbu pokraj ljubičastog drveta.

You can also see Portal here.

>look at torba
Zlatne je boje i možeš je otvoriti!

>open torba
You open the torba, revealing a lampa.

* * *

>s
You can't go that way.

>e
(first opening Prvi portal)
It seems to be locked.

>open torba
You open the torba, revealing a boca vode and a knjiga.

>take knjiga
Taken.

>throw knjiga into rijeka
Bacio si knjigu u rijeku, a u tom trenutku pokrenuo se ogroman vir koji je bacio nazad knjigu do tebe. Nešto se promijenilo!

>look knjiga
Bravo! Portal se otvorio i možeš prijeći dalje!

>e
(first opening Prvi portal)

Pustinja
Sunce piči, nema hlada, temperatura seže preko 40 stupnjeva. Oko tebe je sve pijesak, a jedino što imaš je deva. Na jugu se nalazi portal za prelazak na treći nivo.

You can see Prvi portal and Drugi portal here.

>e
You can't go that way.

>s
(first opening Drugi portal)
It seems to be locked.

>w
Prasuma
Prašuma je kišna šuma puna čudnovatih zvijeri koje mogu zbuniti posjetitelje. Počela je lagano padati kiša, a u pozadini se čuju razni čudni zvukovi. U cijeloj prašumi posebno se ističe veliko, ljubičasto drvo koje ima crne plodove. Kroz prašumu prolazi snažna rijeka. Na istoku se nalazi portal koji vodi u drugu razinu.

Vidiš torbu pokraj ljubičastog drveta.

Crni plodovi, neobičnog izgleda i mirisa.

Osjetivši čovjekovu prisutnost žena mačka je došla i cijelo vrijeme je njen pogledam usmjeren ka tebi.

You can also see Prvi portal here.

* * *

>open torba
You open the torba, revealing a boca vode and a knjiga.

>look boca
Boca čiste i pitke vode koja se može popiti.

>drink boca
Ova boca vode me je osvježila i odmah nestala iz mojih ruku. Bolje da što prije odem iz ove prašume!

>inventory
You are carrying nothing.

>take boca
You can't see any such thing.

>take knjiga
Taken.

>inventory
You are carrying:
  a knjiga

>throw knjiga into rijeka
Bacio si knjigu u rijeku, a u tom trenutku pokrenuo se ogroman vir koji je bacio nazad knjigu do tebe. Nešto se promijenilo!

>w
You can't go that way.

>s
You can't go that way.

* * *

>n
You can't go that way.

>e
(first opening Prvi portal)

Pustinja
Sunce piči, nema hlada, temperatura seže preko 40 stupnjeva. Oko tebe je sve pijesak, a jedino što imaš je deva. Na jugu se nalazi portal za prelazak na treći nivo.

Užareni pijesak lako propada pod nogama.

You can also see Prvi portal and Drugi portal here.

>w
Prasuma
Prašuma je kišna šuma puna čudnovatih zvijeri koje mogu zbuniti posjetitelje. Počela je lagano padati kiša, a u pozadini se čuju razni čudni zvukovi. U cijeloj prašumi posebno se ističe veliko, ljubičasto drvo koje ima crne plodove. Kroz prašumu prolazi snažna rijeka. Na istoku se nalazi portal koji vodi u drugu razinu.

Vidiš torbu pokraj ljubičastog drveta.

Crni plodovi, neobičnog izgleda i mirisa.

Osjetivši čovjekovu prisutnost žena mačka je došla i cijelo vrijeme je njen pogledam usmjeren ka tebi.

You can also see Prvi portal here.

>e
Pustinja
Sunce piči, nema hlada, temperatura seže preko 40 stupnjeva. Oko tebe je sve pijesak, a jedino što imaš je deva. Na jugu se nalazi portal za prelazak na treći nivo.

Užareni pijesak lako propada pod nogama.

You can also see Prvi portal and Drugi portal here.

>n
You can't go that way.

>e
You can't go that way.

* * *

>e
Pustinja
Sunce piči, nema hlada, temperatura seže preko 40 stupnjeva. Oko tebe je sve pijesak, a jedino što imaš je deva. Na jugu se nalazi portal za prelazak na treći nivo.

Užareni pijesak lako propada pod nogama.

You can also see Prvi portal and Drugi portal here.

>look deva
You can't see any such thing.

* * *

>w
(first opening Treci portal)
It seems to be locked.

>s
You can't go that way.

* * *

>n
You can't go that way.

>e
(first opening Prvi portal)
It seems to be locked.

* * *

>w
(first opening Treci portal)
It seems to be locked.

>insert voda into flasa
Staklena flaša je napunjena vodom.

>w
(first opening Treci portal)
Došao si do kraja igrice! Čestitam!

    *** The End ***

Would you like to RESTART, RESTORE a saved game, QUIT or UNDO the last command?

* * *

>take a boCA
You can't see any such thing.

>take boca
You can't see any such thing.

>open torba
You open the torba, revealing a boca.

* * *

>take boca
Taken.

>drink boca
There's nothing suitable to drink here.

* * *

>open torba
You open the torba, revealing a boca.

>drink boca
There's nothing suitable to drink here.

* * *

>open torba
You open the torba, revealing a boca vode and a knjiga.

>drink boca
Ova boca vode me je osvježila!

>drink torba
There's nothing suitable to drink here.

>drink kfpekfe
You can't see any such thing.

* * *

>open torba
You open the torba, revealing a boca vode and a knjiga.

>look boca vode
Boca čiste i pitke vode koja se može popiti.

>drink boca vode
Ova boca vode me je osvježila i odmah nestala iz mojih ruku. Bolje da što prije odem iz ove prašume!

>drink torba
torba se ne pije!

>close torba
You close the torba.

>open torba
You open the torba.

>inventory
You are carrying nothing.

>look drvo
Veliko i raskošno drvo čudnih plodova.

On the veliko ljubicasto drvo is a crni plodovi.

>look plodovi
You see nothing special about the crni plodovi.

* * *

>open torba
You open the torba, revealing a boca vode and a knjiga.

>throw knjiga into rijeka
Bacio si knjigu u rijeku, a u tom trenutku pokrenuo se ogroman val koji je bacio nazad knjigu do tebe. Nešto se promijenilo!

>e
(first opening Prvi portal)

Napustena koliba
Našao si se u napuštenoj kolibi punoj prašine s malo izvora svjetlosti. U kolibi se najviše ističe klavir, veliki drveni stol i kauč.

You can see Prvi portal, Drugi portal, Drveni stol and Kauc (on which is Tabakera (closed)) here.

>look sjedalo
You see nothing special about Sjedalo.

>look sjedalo
You see nothing special about Sjedalo.

>take sjedalo
Taken.

>inventory
You are carrying:
  Sjedalo

>drop sjedao
You can't see any such thing.

>drop sjedalo
Dropped.

* * *

>e
(first opening Prvi portal)

Napustena koliba
Našao si se u napuštenoj kolibi punoj prašine s malo izvora svjetlosti. U kolibi se najviše ističe klavir, veliki drveni stol i kauč.

You can see Prvi portal, Drugi portal, Drveni stol and Kauc (on which is Tabakera (closed)) here.

>look under sjedalo
You can't see any such thing.

>look sjedalo
You can't see any such thing.

>look under sjedalo
You can't see any such thing.

>open sjedalo
You can't see any such thing.

>look vrecica
You can't see any such thing.

>look deva
Pustinjska životinja koja na sebi nosi veliku torbu.

>look sjedalo
You can't see any such thing.

* * *

>look under sjedalo
You can't see any such thing.

>look under sjedalo
You can't see any such thing.

>take pijesak
Pijesak je jako vruć i dobit ćeš opekotine!

>take pijesak
Pijesak je jako vruć i dobit ćeš opekotine!

>look pijesak
Užareni pijesak lako propada pod nogama.

>look deva
Pustinjska životinja koja na sebi nosi veliku torbu.

* * *

>e
(first opening Prvi portal)

Napustena koliba
Našao si se u napuštenoj kolibi punoj prašine s malo izvora svjetlosti. U kolibi se najviše ističe klavir, veliki drveni stol i kauč.

You can see Prvi portal, Drugi portal, Drveni stol and Kauc (on which is Tabakera (closed)) here.

>look kauc
Oronuli kauč na kojem se nalazi tabakera.

On Kauc is Tabakera (closed).

>look at tabaker
You can't see any such thing.

>look at tabakera
Tabakera je kutija za cigarete, može se otovriti.

>open tabakera
Ključ za otključavanje škrinje je uspješno nađen!

>inventory
You are carrying nothing.

>take kljuc
You can't see any such thing.

* * *

>throw knjiga into rijeka
Bacio si knjigu u rijeku, a u tom trenutku pokrenuo se ogroman val koji je bacio nazad knjigu do tebe. Nešto se promijenilo!

>look at knjiga
Bravo! Portal se otvorio i možeš prijeći dalje!

>e
(first opening Prvi portal)

Napustena koliba
Našao si se u napuštenoj kolibi punoj prašine s malo izvora svjetlosti. U kolibi se najviše ističe klavir, veliki drveni stol i kauč.

You can see Prvi portal, Drugi portal, Drveni stol and Kauc (on which is Tabakera (closed)) here.

>open tabakera
Ključ za otključavanje škrinje je uspješno nađen!

>inventora
That's not a verb I recognise.

>inventory
You are carrying nothing.

>open tabakera
You open Tabakera, revealing a kljuc.

* * *

>drink boca
You can't see any such thing.

>drinking boca
That's not a verb I recognise.

>drink boca
You can't see any such thing.

* * *

>open torbađ
You can't see any such thing.

>open torba
You open the torba, revealing a boca.

>drink boca
Ugh. You're probably going to regret that in about an hour.

>drink boca
Ugh. You're probably going to regret that in about an hour.

* * *

>drink torba
torba se ne pije!

>drink boca
You can't see any such thing.

>open torba
You open the torba, revealing a boca.

>drink boca
Ova boca vode me je osvježila!

* * *

>drink torba
torba se ne pije!

>open torba
You open the torba, revealing a boca vode.

>drink boca vode
Ova boca vode me je osvježila!

>drink torba
Ne pomžeš to popiti.

* * *

>drink boca vode
Ova boca vode me je osvježila!

>drink boca vode
You can't see any such thing.

>drink torba
torba se ne pije!

>drink torba
torba se ne pije!

* * *

>drink boca vode
Ova boca vode me je osvježila!

I beg your pardon?

I beg your pardon?

* * *

>open torba
You open the torba, revealing a boca vode.

>drink boca
boca vode se ne pije!

>drink boca vode
boca vode se ne pije!

* * *

>open torba
You open the torba, revealing a boca vode.

>drink boc vode
You can't see any such thing.

>drink boca vode
boca vode se ne pije!

I beg your pardon?

* * *

>open torba
You open the torba, revealing a boca vode.

>take boca vode
Taken.

>inventory
You are carrying:
  a boca vode

>drink boca vode
Ova boca vode me je osvježila i odmah nestala iz mojih ruku. Bolje da što prije odem iz ove prašume!

>inventory
You are carrying nothing.

>open torba
That's already open.

>close torba
You close the torba.

* * *

>drink boca vode
Ova boca vode me je osvježila!

>drink boca vode
Ova boca vode me je osvježila!

* * *

>drink torba
torba se ne pije!

>look at torba
Zlatne je boje i možeš je otvoriti!

>open torba
You open the torba, revealing a boca vode.

>drink boca vode
boca vode se ne pije!

* * *

>drink torba
torba se ne pije!

>open troba
You can't see any such thing.

>open torba
You open the torba, revealing a boca vode.

>drink boca vode
Ova boca vode me je osvježila!

That isn't available.

>drink boca vode
You can't see any such thing.

* * *

>drink torba
torba se ne pije!

>drink fdfd
You can't see any such thing.

>open torba
You open the torba, revealing a boca vode.

>drink boca
Ova boca vode me je osvježila!

>drink boca
Ova boca vode me je osvježila!

* * *

>drink troba
You can't see any such thing.

>drink torba
torba se ne pije!

* * *

>drink boca
Ova boca vode me je osvježila!

>drink voda
You can't see any such thing.

>drink boca
Ova boca vode me je osvježila!

* * *

>drink torba
torba se ne pije!

>open boca
You can't see any such thing.

>open torba
You open the torba, revealing a boca vode.

* * *

>drink boca vode
You can't see any such thing.

* * *

>take plodovi
Oprez plodovi nisu jestivi jer su otrovni i ne možeš ih ponijeti!!!

>eat plodovi
crni plodovi se ne jede!

>eat torba
torba se ne jede!

>eat boca
You can't see any such thing.

>inventory
You are carrying:
  a crni plodovi

>open torba
You open the torba, revealing a boca vode.

* * *

>take boca vode
Taken.

>inventora
That's not a verb I recognise.

>inventory
You are carrying:
  a boca vode
  a crni plodovi

* * *

>look at plodovi
You see nothing special about the crni plodovi.

>look plodovi
You see nothing special about the crni plodovi.

>look orba
You can't see any such thing.

>look at torba
Zlatne je boje i možeš je otvoriti!

>eat plodovi
crni plodovi se ne jede!

>take plodovi
Oprez plodovi nisu jestivi jer su otrovni!!!

Taken.

* * *

>eat torba
torba se ne jede!

>eat plodovi
crni plodovi se ne jede!

>take plodovi
Oprez plodovi nisu jestivi jer su otrovni!!!

>inventory
You are carrying nothing.

* * *

>take crni plodovi
Oprez plodovi nisu jestivi jer su otrovni i ne možeš ih ponijeti!!!

>eat crni polodovi
I only understood you as far as wanting to eat the crni plodovi.

>eat crni plodovi
crni plodovi se ne jede!

* * *

>look zena macka
Žena duge smeđe kose obučena u crno usko odjelo. Svojim prodornim, zelenim očima može svakoga očarati tako da budi na oprezu!

>look at stablo
You can't see any such thing.

>look at drvo
Veliko i raskošno drvo čudnih plodova.

On the veliko ljubicasto drvo is a crni plodovi.

>look at torba
Zlatne je boje i možeš je otvoriti!

* * *

>take boca vode
Taken.

>drink boca vode
Ova boca vode me je osvježila i odmah nestala iz mojih ruku. Bolje da što prije odem iz ove prašume!

>loook boca vode
That's not a verb I recognise.

* * *

>look torba
Zlatne je boje i možeš je otvoriti!

>open torba
You open the torba, revealing a boca vode and a knjiga.

>look njiga
You can't see any such thing.

>look knjiga
Knjiga nepoznatog autora sa sumnjivim sadržajem!

* * *

>throw knjiga into rijeka
Bacio si knjigu u rijeku, a u tom trenutku pokrenuo se ogroman val koji je bacio nazad knjigu do tebe. Nešto se promijenilo!

>e
(first opening Prvi portal)

Pustinja
Sunce piči, nema hlada, temperatura seže preko 40 stupnjeva. Oko tebe je sve pijesak, a jedino što imaš je deva. Na jugu se nalazi portal za prelazak na treći nivo.

Užareni pijesak lako propada pod nogama.

Sjedalo je svijetle boje napravljeno od čvrste tkanine.

Deva ima dvije grbe te je navikla na vrućine. Na sebi ima sjedalo za lakše jahanje.

You can also see Prvi portal and Drugi portal here.

>look sjedalo
You see nothing special about Sjedalo.

* * *

>inventory
You are carrying:
  Sjedalo

>drop sjedalo
Dropped.

>look under sjedalo
You find nothing of interest.

* * *

>go portal
(first opening Portal)
It seems to be locked.

>look torba
Zlatne je boje i možeš je otvoriti!

* * *

>open torba
You open the torba, revealing a boca vode and a knjiga.

>drink torba
torba se ne pije!

>drink boca vode
Ova boca vode me je osvježila i odmah nestala iz mojih ruku. Bolje da što prije odem iz ove prašume!

>take knjiga
Taken.

>look knjiga
Knjiga nepoznatog autora sa sumnjivim sadržajem!

>look drvo
Veliko i raskošno drvo čudnih plodova.

On the veliko ljubicasto drvo is a crni plodovi.

>take plodovi
Oprez plodovi nisu jestivi jer su otrovni i ne možeš ih ponijeti!!!

>look plodovi
You see nothing special about the crni plodovi.

>eat plodovi
crni plodovi se ne jede!

>drink boca vode
You can't see any such thing.

>inventory
You are carrying:
  a knjiga

>ask zena macka about knjiga
Moraš što prije uništiti knjigu za vlastito dobro!

>throw knjiga in rijeka
Bacio si knjigu u rijeku, a u tom trenutku pokrenuo se ogroman vir koji je bacio nazad knjigu do tebe. Nešto se promijenilo!

>look knjiga
Bravo! Portal se otvorio i možeš prijeći dalje!

>go portal
(first opening Portal)

Pustinja
You can see Portal here.

>go north
You can't go that way.

* * *

>go portal
(first opening Portal)
It seems to be locked.

>n
You can't go that way.

>e
(first opening Portal)
It seems to be locked.

>w
Pustinja
You can see Portal here.

>e
Prasuma
Prašuma je kišna šuma puna čudnovatih zvijeri koje mogu zbuniti posjetitelje. Počela je lagano padati kiša, a u pozadini se čuju razni čudni zvukovi. U cijeloj prašumi posebno se ističe veliko, ljubičasto drvo koje ima crne plodove. Kroz prašumu prolazi snažna rijeka. Na istoku se nalazi portal koji vodi u drugu razinu.

Vidiš torbu pokraj ljubičastog drveta.

Crni plodovi, neobičnog izgleda i mirisa.

Osjetivši čovjekovu prisutnost žena mačka je došla i cijelo vrijeme je njen pogledam usmjeren ka tebi.

You can also see Portal here.

* * *

>e
(first opening Prvi portal)
It seems to be locked.

>w
Pustinja
Sunce piči, nema hlada, temperatura seže preko 40 stupnjeva. Oko tebe je sve pijesak, a jedino što imaš je deva.

You can see Portal here.

>look portal
Portal služi prelasku iz jednog u drugi level!

* * *

>e
(first opening Prvi portal)
It seems to be locked.

>s
You can't go that way.

* * *

>n
You can't go that way.

>w
You can't go that way.

>open torba
You open the torba, revealing a boca vode and a knjiga.

* * *

>throw knjiga into rijeka
Bacio si knjigu u rijeku, a u tom trenutku pokrenuo se ogroman val koji je bacio nazad knjigu do tebe. Nešto se promijenilo!

>look knjiga
Bravo! Portal se otvorio i možeš prijeći dalje!

>e
(first opening Prvi portal)

] Napustena koliba
Našao si se u napuštenoj kolibi punoj prašine s malo izvora svjetlosti. U kolibi se najviše ističe klavir, veliki drveni stol i kauč.

Jabuka koja je posmeđila.

Stari klavir koji se i dalje može svirati.

You can also see Prvi portal, Drugi portal, Kauc (on which is Tabakera (closed)) and skrinja (closed) here.

>open skrinja
Nemam kljuc za otvoriti škrinju

>open tabakera
U tabakeri se nalazi ključ. 
Ključ za otključavanje škrinje je uspješno nađen!

>open skrinja
Škrinju sam otvorio ključem.
U škrinji se nalazi papir sa zanimljivom porukom! Bolje pogledaj u papir.

>look papir
Za prelazak u treću razinu potrebno je zaplesati! Znam da znaš i zato kreni!

>dance
Odlično ti ide. Otključao si prolaz u treći nivo!

>s
(first opening Drugi portal)

Pustinjska oaza
Sunce piči, vruće je, ali oko tebe su drveća koja čine hlad, izvor vode i ležaljka. Stigao je beduin!

Beduin je stariji čovjek pun mudrosti.

You can also see Drugi portal, Treci portal, Bijela kapa, Izvor vode (in which is Voda) and Staklena flasa here.

>look bijela kapa
Lagana bijela kapa koja te zaštičuje od sunca. Slobodno je probaj!

>n
] Napustena koliba
Našao si se u napuštenoj kolibi punoj prašine s malo izvora svjetlosti. U kolibi se najviše ističe klavir, veliki drveni stol i kauč.

Jabuka koja je posmeđila.

Stari klavir koji se i dalje može svirati.

You can also see Drugi portal, Prvi portal, Kauc (on which is Tabakera (closed)) and skrinja (in which is papir) here.

>s
Pustinjska oaza
Sunce piči, vruće je, ali oko tebe su drveća koja čine hlad, izvor vode i ležaljka. Stigao je beduin!

Beduin je stariji čovjek pun mudrosti.

You can also see Drugi portal, Treci portal, Bijela kapa, Izvor vode (in which is Voda) and Staklena flasa here.

>e
You can't go that way.

>w
(first opening Treci portal)
It seems to be locked.

* * *

>s
You can't go that way.

>look izvor vode
Svježa, hladna i pitka voda!

In Izvor vode is Voda.

>look staklena flasa
Ostavljena, prazna staklena flaša.

>look beduin
Pustinjski nomad. Možeš ga pitati o staklenoj boci.

>ask beduin about flasa
Ukoliko napuniš staklenu flašu vodom tada prelaziš level!

>insert voda into flasa
Staklena flaša je napunjena vodom.

* * *

>s
You can't go that way.

* * *

>e
(first opening Portal)
It seems to be locked.

>go portal
(first opening Portal)
It seems to be locked.

>throw knjiga into rijeka
You can't see any such thing.

I beg your pardon?

>open torba
You open the torba, revealing a boca vode and a knjiga.

>look knjiga
Knjiga nepoznatog autora sa sumnjivim sadržajem!

>throw knjiga into rijeka
Bacio si knjigu u rijeku, a u tom trenutku pokrenuo se ogroman vir koji je bacio nazad knjigu do tebe. Nešto se promijenilo!

* * *

>look knjiga
Bravo! Portal se otvorio i možeš prijeći dalje!

>e
(first opening Portal)

Pustinja
You can see Portal here.

* * *

>n
You can't go that way.

* * *

>e
(first opening Prvi portal)

Napustena koliba
Našao si se u napuštenoj kolibi punoj prašine s malo izvora svjetlosti. U kolibi se najviše ističe klavir, veliki drveni stol i kauč.

You can see Prvi portal, Drugi portal, Drveni stol and Kauc (on which is Tabakera (closed)) here.

>n
You can't go that way.

* * *

>e
You can't go that way.

>w
Prasuma
Prašuma je kišna šuma puna čudnovatih zvijeri koje mogu zbuniti posjetitelje. Počela je lagano padati kiša, a u pozadini se čuju razni čudni zvukovi. U cijeloj prašumi posebno se ističe veliko, ljubičasto drvo koje ima crne plodove. Kroz prašumu prolazi snažna rijeka. Na istoku se nalazi portal koji vodi u drugu razinu.

Vidiš torbu pokraj ljubičastog drveta.

Crni plodovi, neobičnog izgleda i mirisa.

Osjetivši čovjekovu prisutnost žena mačka je došla i cijelo vrijeme je njen pogledam usmjeren ka tebi.

You can also see Prvi portal here.

>e
Napustena koliba
Našao si se u napuštenoj kolibi punoj prašine s malo izvora svjetlosti. U kolibi se najviše ističe klavir, veliki drveni stol i kauč.

You can see Prvi portal, Drugi portal, Drveni stol and Kauc (on which is Tabakera (closed)) here.

>s
(first opening Drugi portal)
It seems to be locked.

>look at drveni stol
Stari drveni stol smeđe boje kojeg je prekrila prašina. Ispod njega nalazi se mala i neobična škrinja.

>look under the table
You can't see any such thing.

>look drveni stol
Stari drveni stol smeđe boje kojeg je prekrila prašina. Ispod njega nalazi se mala i neobična škrinja.

>look under the stol
You find nothing of interest.

>look under stol
You find nothing of interest.

>look kauc
Oronuli kauč na kojem se nalazi tabakera.

On Kauc is Tabakera (closed).

>look tabakera
Tabakera je kutija za cigarete, može se otovriti.

>open tabakera
Ključ za otključavanje škrinje je uspješno nađen!

>look kljuc
Ključ za otvoriti škrinju.

>look kauc
Oronuli kauč na kojem se nalazi tabakera.

On Kauc is Tabakera (closed).

* * *

>look tabakera
Tabakera je kutija za cigarete, može se otovriti.

>take tabakera
Taken.

>drop tabakera
Dropped.

>open tabakera
You open Tabakera.

>close tabakera
You close Tabakera.

>open tabakera
You open Tabakera.

>look kljuc
Ključ za otvoriti škrinju.

>take kljuc
You already have that.

>inventora
That's not a verb I recognise.

>inventory
You are carrying:
  a kljuc

* * *

>e
You can't go that way.

>s
You can't go that way.

>w
(first opening Treci portal)
Došao si do kraja igrice! Čestitam!

    *** The End ***

Would you like to RESTART, RESTORE a saved game, QUIT or UNDO the last command?

* * *

>look table
You can't see any such thing.

>look stol
Stari drveni stol smeđe boje kojeg je prekrila prašina. Ispod njega nalazi se mala i neobična škrinja.

>look under stol
You find nothing of interest.

* * *

>look kauc
Oronuli kauč na kojem se nalazi tabakera.

On Kauc is Tabakera (closed).

>open tabakera
*** Run-time problem P10: Since the skrinja under the table is not allowed the property "locked", it is against the rules to try to use it.

Ključ za otključavanje škrinje je uspješno nađen!

* * *

>look kauc
Oronuli kauč na kojem se nalazi tabakera.

On Kauc is Tabakera (closed).

>look tabakera
Tabakera je kutija za cigarete te se može otvoriti.

>open tabakera
*** Run-time problem P10: Since the skrinja under the table is not allowed the property "locked", it is against the rules to try to use it.

Ključ za otključavanje škrinje je uspješno nađen!

* * *

>look tabakera
Tabakera je kutija za cigarete te se može otvoriti.

>look drveni stol
Stari drveni stol smeđe boje kojeg je prekrila prašina. Ispod njega nalazi se mala i neobična škrinja.

>look skrinja
You can't see any such thing.

>look under stol
You find nothing of interest.

* * *

>look tabakera
Tabakera je kutija za cigarete te se može otvoriti.

>open tabakera
U tabakeri se nalazi ključ 
 Ključ za otključavanje škrinje je uspješno nađen!

>look drveni stol
Stari drveni stol smeđe boje kojeg je prekrila prašina. Ispod njega nalazi se mala i neobična škrinja.

>look under stol
You find nothing of interest.

>look under drveni stol
You find nothing of interest.

I beg your pardon?

>inventory
You are carrying:
  a kljuc

* * *

>play klavir
Grozno zvučiš, potrebno je uštimati Klavir!

>play kauc
Kauc ne možeš svirati!

>play drveni stol
Drveni stol ne možeš svirati!

* * *

>play klavir
Grozno zvučiš, potrebno je uštimati Klavir!

>tune klavir
Klavir je uštiman i spreman za sviranje.

>tune klavir
Klavir je uštiman i spreman za sviranje.

>play klavir
Prekrasno sviraš i zvuči odlično!

>play tabakera
Tabakera ne možeš svirati!

* * *

>d
You can't go that way.

* * *

>play kauc
Kauc ne možeš svirati!

>play klavir
Klavir ne možeš svirati!

* * *

>tune tabakera
Tabakera ne možeš uštimati!

>tune klavir
Klavir je uštiman i spreman za sviranje.

>look kalvir
You can't see any such thing.

>look klavir
Instrument za sviranje.

>play klavir
Prekrasno sviraš i zvuči odlično!

* * *

>open tabakera
U tabakeri se nalazi ključ. 
Ključ za otključavanje škrinje je uspješno nađen!

I beg your pardon?

* * *

>open tabakera
U tabakeri se nalazi ključ. 
Ključ za otključavanje škrinje je uspješno nađen!

>inventory
You are carrying:
  a kljuc

>look table
You can't see any such thing.

* * *

>open tabakera
U tabakeri se nalazi ključ. 
Ključ za otključavanje škrinje je uspješno nađen!

>drop kljuc
Dropped.

>take kljuc
Taken.

>inventor
That's not a verb I recognise.

>inventory
You are carrying:
  a kljuc

* * *

>open tabakera
U tabakeri se nalazi ključ. 
Ključ za otključavanje škrinje je uspješno nađen!

>look under stol
Škrinja! Pronašao sam škrinju!

>open skrinja
You can't see any such thing.

* * *

>look under stol
Škrinja! Pronašao sam škrinju!

>look skrinja
You can't see any such thing.

>look at skrinja
You can't see any such thing.

* * *

>look under table
You can't see any such thing.

>look under stol
You find nothing of interest.

* * *

>look stol
Stari drveni stol smeđe boje kojeg je prekrila prašina. Ispod njega nalazi se mala i neobična škrinja.

>look under table
You can't see any such thing.

>look under stol
Škrinja! Pronašao sam škrinju!

* * *

>look skrinja
You can't see any such thing.

>look kauc
Oronuli kauč na kojem se nalazi tabakera.

On Kauc is Tabakera (closed).

>open tabakera
Ključ za otključavanje škrinje je uspješno nađen!

>inventory
You are carrying:
  a kljuc

>open skrinja
You can't see any such thing.

>look skrinja
You can't see any such thing.

* * *

>take kljuc
You can't see any such thing.

>open tabakera
U tabakeri se nalazi ključ. 
Ključ za otključavanje škrinje je uspješno nađen!

* * *

>inventory
You are carrying:
  a kljuc

>play klavir
Grozno zvučiš, potrebno je uštimati Klavir!

* * *

>tune klavir
Klavir je uštiman i spreman za sviranje.

>play klavir
Prekrasno sviraš i odlično zvuči!

>play kauc
Kauc ne možeš svirati!

>play tabakera
Tabakera ne možeš svirati!

>tune kauc
Kauc ne možeš uštimati!

>look kljuc
Ključ za otvoriti škrinju.

>look stol
Stari drveni stol smeđe boje kojeg je prekrila prašina. Ispod njega nalazi se mala i neobična škrinja.

>look under stol
Škrinja! Pronašao sam škrinju!

* * *

>look drveni stol
Stari drveni stol smeđe boje kojeg je prekrila prašina. Ispod njega nalazi se mala i neobična škrinja.

>look under stol
Škrinja! Pronašao sam škrinju!

* * *

>open skrinja
Nemam kljuc za otvoriti škrinju

>look under stol
Škrinja! Pronašao sam škrinju!

* * *

>open skrinja
You can't see any such thing.

>inventory
You are carrying nothing.

* * *

>open skrinja
Nemam kljuc za otvoriti škrinju

>open skrinja
You can't see any such thing.

>open tabaker
You can't see any such thing.

>open tabaker<
You can't see any such thing.

>open tabakera
U tabakeri se nalazi ključ. 
Ključ za otključavanje škrinje je uspješno nađen!

* * *

>open skrinja
Nemam kljuc za otvoriti škrinju

>opening skrinja
That's not a verb I recognise.

>open skrinja
You can't see any such thing.

* * *

>open skrinja
Nemam kljuc za otvoriti škrinju

>look skrinja
Drvena škrinja koja čuva tajnu prelaska u treću razinu. Zaključana je!

>look kauc
Oronuli kauč na kojem se nalazi tabakera.

On Kauc is Tabakera (closed).

* * *

>look tabakera
Tabakera je kutija za cigarete te se može otvoriti.

>open tabakera
U tabakeri se nalazi ključ. 
Ključ za otključavanje škrinje je uspješno nađen!

>open skrinja
Škrinju sam otvorio ključem.

* * *

>open tabakera
U tabakeri se nalazi ključ. 
Ključ za otključavanje škrinje je uspješno nađen!

>open skrinja
Škrinju sam otvorio ključem.
U škrinji se nalazi papir sa zanimljivom porukom! Bolje pogledaj u papir

>inventory
You are carrying:
  a kljuc

>close skrinja
That's already closed.

* * *

>open skrinja
Škrinju sam otvorio ključem.
U škrinji se nalazi papir sa zanimljivom porukom! Bolje pogledaj u papir

>close skrinja
You close skrinja.

>look skrinja
Drvena škrinja koja čuva tajnu prelaska u treću razinu. Zaključana je!

>open skrinja
Škrinju sam otvorio ključem.

>open skrinja
Škrinju sam otvorio ključem.

* * *

>open skrinja
Škrinju sam otvorio ključem.
U škrinji se nalazi papir sa zanimljivom porukom! Bolje pogledaj u papir

>look papir
Za prelazak u treću razinu potrebno je zaplesati salsu! Znam da znaš i zato kreni!

>go s
(first opening Drugi portal)
It seems to be locked.

* * *

>open skrinja
Škrinju sam otvorio ključem.
U škrinji se nalazi papir sa zanimljivom porukom! Bolje pogledaj u papir

>look at papir
You see nothing special about papir.

>look skrinja
Drvena škrinja koja čuva tajnu prelaska u treću razinu. Zaključana je!

In skrinja is papir.

* * *

>open srinja
You can't see any such thing.

>open skrinja
You can't see any such thing.

* * *

>look skrinja
Drvena škrinja koja čuva tajnu prelaska u treću razinu. Zaključana je!

* * *

>open skrinja
Škrinju sam otvorio ključem.

>inventory
You are carrying nothing.

* * *

>dance salsa
I only understood you as far as wanting to dance.

>dance
Odlično ti ide. Otključao si prolaz u treći nivo!

>s
(first opening Drugi portal)

Pustinjska oaza
Ovdje je prostor za uživanje gdje možeš pokazati svoj talent!

You can see Drugi portal here.

* * *

>look bijela kapa
Lagana bijela kapa koja te zaštičuje od sunca. Slobodno je probaj!

>take bijela kapa
Taken.

>wear bijela kapa
You can't wear that!

* * *

>look bijela kapa
Lagana bijela kapa koja te zaštičuje od sunca. Slobodno je probaj!

>w
(first opening Treci portal)
It seems to be locked.

>look izvor vode
Svježa, hladna i pitka voda!

In Izvor vode is Voda.

* * *

>look staklena flasa
Ostavljena, prazna staklena flaša.

>wear bijela kapa
(first taking Bijela kapa)
You put on Bijela kapa.

>look voda
You see nothing special about Voda.

>insert voda into flasa
Staklena flaša je napunjena vodom.

>look flasa
Staklena flaša je puna vode!

>insert voda intp flasa
I didn't understand that sentence.

>insert voda into flasa
Staklena flaša je već puna vode!

>w
(first opening Treci portal)
Došao si do kraja igrice! Čestitam!

    *** The End ***

Would you like to RESTART, RESTORE a saved game, QUIT or UNDO the last command?

* * *

>wear kapa
(first taking Bijela kapa)
You put on Bijela kapa.

>put down bijela kapa
(first taking Bijela kapa off)
Dropped.

>inventor<
That's not a verb I recognise.

>inventory
You are carrying nothing.

>take bijela kapa
Taken.

>inventory
You are carrying:
  Bijela kapa

>wear bijela kapa
You put on Bijela kapa.

>inventory
You are carrying:
  Bijela kapa (being worn)

* * *

>wear bijela kapa
(first taking Bijela kapa)
You put on Bijela kapa.

>inventory
You are carrying:
  Bijela kapa (being worn)

>wear off bijela kapa
You can't see any such thing.

>drop bijela kapa
(first taking Bijela kapa off)
Dropped.

>take  of bijela kapa
You can't see any such thing.

>wear bijela kapa
(first taking Bijela kapa)
You put on Bijela kapa.

>take of bijela kapa
You can't see any such thing.

>take off bijela kapa
You take off Bijela kapa.

* * *

>sit on lezaljka
That's not something you can sit down on.

>sit on lezaljka
That's not something you can sit down on.

* * *

>get in lezaljka
That's not something you can enter.

* * *

>look lezaljka
Plastična ležaljka bijele boje.

* * *

>insert izvor podataka into flasa
I didn't understand that sentence.

>insert izvor podatala into staklena flasa
I didn't understand that sentence.

>insert izvor vode into staklena flasa
I only understood you as far as wanting to insert Izvor vode into Staklena falsa.

>insert voda into flasa
You can't see any such thing.

>insert voda into staklena flasa
You can't see any such thing.

>insert izvor podataka into staklena flasa
I didn't understand that sentence.

>insert izvor vode into staklena flasa
I only understood you as far as wanting to insert Izvor vode into Staklena falsa.

>look flasa
You can't see any such thing.

>look staklena flasa
I only understood you as far as wanting to look Staklena falsa.

* * *

>look staklena flasa
Ostavljena, prazna staklena flaša.

>look at flasa
You can't see any such thing.

>look staklena
You see nothing special about Staklena falsa.

* * *

>look staklena flasa
Ostavljena, prazna staklena flaša.

>look flasa
Ostavljena, prazna staklena flaša.

>look staklena
Ostavljena, prazna staklena flaša.

>insert voda into staklena flasa
Boca je napunjena.

* * *

>look flasa
Ostavljena, prazna staklena flaša.

>look staklena
You see nothing special about Staklena falsa.

>look staklena flasa
I only understood you as far as wanting to look Staklena falsa.

* * *

>look flasa
Ostavljena, prazna staklena flaša.

>insert voda into flasa
Staklena flaša je napunjena vodom.

>insert voda into flasa
Staklena flaša je već puna vode!

>look flasa
Staklena flaša je puna vode!

* * *

>insert voda into staklena flasa
Boca je napunjena vodom.

>look izvor vode
Svježa, hladna i pitka voda!

In Izvor vode is Voda.

>look boca
You can't see any such thing.

>look staklena flasa
Staklena flaša je napunjena vodom!

* * *

>look beduin
Pustinjski nomad. Možeš ga pitati o staklenoj boci.

>ask beduin about staklena flasa
Ukoliko napuniš staklenu flašu vodom tada prelaziš level!

>ask beduin about staklena
Ukoliko napuniš staklenu flašu vodom tada prelaziš level!

>ask beduin about flasa
Ukoliko napuniš staklenu flašu vodom tada prelaziš level!

>loook bijela kapa
That's not a verb I recognise.

>look bijela kapa
Lagana bijela kapa koja te zaštičuje od sunca. Slobodno je probaj!